111111111111111111111111111111111111111
10000p1100p1110000001011000000001001np1
100000111001110001101100011111101100011
10000000000101101100010100p111101110011
111100000001000010000000101111101100111
111111100001111000110110001111100000011
110000000001110000000000001111111111011
1111000000p1010000001111000011111110001
1p0111001111000011000111000101111p11001
100000001111000111100010000000001001011
111100011101000110000000110001100000001
100000000001100000110001111100111110011
100000000001100100000001101100000110011
1p1110111001001100010011100000110110001
1111111p0001001000111110001101110100111
1111000000p1001101001111011011100001101
111111111011p00101101011001000001000001
1110000010011000001000011000011111s1011
110011000000001p00000000000111111111111
111111111111111111111111111111111111111
